You're currently competing on a Spanish game show. The object of the game is to pick the right key (which are named after conjugations or vocabulary) and unlock the door. To know what the question is you must examine the door. To examine the door type in "x ______". Always examine the door before taking the conjugations. When playing the game, only give simple commands. For example, you can type "toma corro" and the corro key will be put in your bag. The name of the doors are corresponding with the room it leads to. For example, when you're in the Presente room the door is called Future door. However, the description of the door will correspond with the name of the room.  Also, past one (door) is for the preterite and past two is for the imperfecto (door). 
Español Game Show
Conjugation and Vocabulary Practice por Allison Smith
Release 1 / Serial number 141022 / Inform 7 build 6L02 (I6/v6.33 lib 6/12N) SD

Presente
You're currently surrounded by keys (conjugations) that unlock the door! Warning: Don't take the wrong key. Think about the question. Always examine the door first. ¡Hola, tu eres en el Presente! Tu necesitarás encontrar la llave que abre la puerta. Nos divertimos jugando el concurso televisivo. The Futuro is to the east. Juan es una persona.

Puedes ver a Future door, a Juan, a Juega, a Quepo, a Estoy, a Sale y a Pinta aquí.

>take sale
Taken.

>x future door
Ella____la clase ir a dormir.

>x future
Ella____la clase ir a dormir.

>x futuro
You can't see any such thing.

>x future door
Ella____la clase ir a dormir.

>x door
Ella____la clase ir a dormir.

>unlock the future door with sale
You unlock Future door.

>go east
(first opening Future door)

Futuro
Warning: If you choose the wrong key and try to unlock the door you will lose the game. ¡Hola, tu eres en el Futuro! Tu necesitarás encontrar la llave que abre la puerta. The Preterite is to the south.

You can see Future door, Past One, Correrás, Dibujarás, Lavará, Leeré and Pondré here.

>x past one
Yo______ mi libro en la estantería.

>take pondré
Taken.

>unlock past one with pondré
You unlock Past One.

>go s
(first opening Past One)

Preterite
Warning: If you choose the wrong key and try to unlock the door you will lose the game. ¡Hola, tu eres en el Preterite! Tu necesitarás encontrar la llave que abre la puerta. The Imperfecto is to the east.

You can see Past One, Past Two, Fue, Condujo, Comí, Tuvo and Nadé here.

>x past two
En la manaña, yo_____a la playa en mi coche.

>take condujo
Taken.

>unlock past two with condujo
You unlock Past Two.

>go e
(first opening Past Two)

imperfecto
Warning: If you choose the wrong key and try to unlock the door you will lose the game. ¡Hola, tu eres en el Imperfecto! Tu necesitarás encontrar la llave que abre la puerta. Vocabulary is to the north.

You can see Past Two, Vocab, Amaban, Morían, Montaban, Corrían and Caminaban here.

>x vocab
Chicas ______ Justin Bieber antes 2014.

>take amaban
Taken.

>unlock vocab with amaban
You unlock Vocab.

>go w
You can't go back, amiga.

>gon
That's not a verb I recognise.

>n
(first opening Vocab)

Vocabulary
Warning: If you choose the wrong key and try to unlock the door you will lose the game. ¡Hola, tu eres en el Preterite! Tu necesitarás encontrar la llave que abre la puerta. The Final Showcase is to the east.

You can see Vocab, Mix, Sandía, Ojo, Policía, Oso and Invierno here.

>x mix
¿Qué es bear en español?

>unlock mix with oso
(first taking Oso)
You unlock Mix.

>take oso
You already have that.

>unlock mix with oso
That's unlocked at the moment.

>w
You can't go that way.

>e
(first opening Mix)

Final Showcase
¡Finalmente! Tuviste a la final. Tu necesitarás abrir el baúl ganar.

You can see Mix, Chest (closed), Escucho, Manzana, Besaba, Cantará and Zapato here.

>take poner
You can't see any such thing.

>take zapatos
You can't see any such thing.

>take zapato
Taken.

>unlock chest with zapato
You unlock Chest.

>open chest
You open Chest, revealing Win.

* * *

>take sale
Taken.

>unlock futuro question with sale
You can't see any such thing.

>x futuro question
You can't see any such thing.

>unlock door with sale
You unlock Future door.

>e
(first opening Future door)

Futuro
Warning: If you choose the wrong key and try to unlock the door you will lose the game. ¡Hola, tu eres en el Futuro! Tu necesitarás encontrar la llave que abre la puerta. The Preterite is to the south.

You can see Future door, Past One, Correrás, Dibujarás, Lavará, Leeré and Pondré here.

>unlock door
(with Sale)
That's unlocked at the moment.

* * *

>x juega
jugar

>x quepo
caber

* * *

>take all
No conozco ese verbo.

>take
What do you want to take?

>all
no way josé

* * *

>take all
No conozco ese verbo.

>toma all
No veo eso que dices.

>toma todo
no way josé

* * *

>take all
No conozco ese verbo.

>take sale
No conozco ese verbo.

>take a sale
No conozco ese verbo.

>tomo sale
No conozco ese verbo.

>toma sale
Cogido.

>i
 Llevas:
  a Sale

>open door
No conozco ese verbo.

>abre
( Sale)
No es algo que pueda abrirse.

>abre puerta
No veo eso que dices.

>abierto la perta
No conozco ese verbo.

>abre future door
Está cerrado con llave.

>desbloquea future door con sale
No conozco ese verbo.

>abre future door con sale
 Quitas el cerrojo a future door.

>e
(abriendo primero Future door)

Futuro
Warning: Don't take the wrong key. Think about the question. Always examine the door first. ¡Hola, tu eres en el Futuro! Tu necesitarás encontrar la llave que abre la puerta. The Preterite is to the south.

Puedes ver a Future door, a Past One, a Correrás, a Dibujarás, a Lavará, a Leeré y a Pondré aquí.

>toma pondré
Cogido.

>x  past one
Yo______ mi libro en la estantería.

>s
(abriendo primero Past One)
Está cerrado con llave.

>sur
No conozco ese verbo.

>s
(abriendo primero Past One)
Está cerrado con llave.

>n
No puedes ir por ahí.

>a
No conozco ese verbo.

>e
No puedes ir por ahí.

>w
You can't go back, amiga.

>abre past one con pondré
 Quitas el cerrojo a past one.

>s
(abriendo primero Past One)

Preterite
Warning: Don't take the wrong key. Think about the question. Always examine the door first. ¡Hola, tu eres en el Preterite! Tu necesitarás encontrar la llave que abre la puerta. The Imperfecto is to the east.

Puedes ver a Past One, a Past Two, a Fue, a Condujo, a Comí, a Tuvo y a Nadé aquí.

>x past two
En la manaña, yo_____a la playa en mi coche.

>toma Comí
Cogido.

    *** ¿Por qué? Necesitarás pensar. ***

¿Quieres REINICIAR, RECUPERAR un juego guardado, TERMINAR o hacer UNDO del último comando?

>toma condujo
por favor, responde a alguna de arriba.

¿Quieres REINICIAR, RECUPERAR un juego guardado, TERMINAR o hacer UNDO del último comando?

>undo
Preterite
[Retrocediendo al turno anterior.]

>toma condujo
Cogido.

>abre past two con condujo
 Quitas el cerrojo a past two.

>e
(abriendo primero Past Two)

Imperfecto
Warning: Don't take the wrong key. Think about the question.Always examine the door first. ¡Hola, tu eres en el Imperfecto! Tu necesitarás encontrar la llave que abre la puerta. Vocabulary is to the north.

Puedes ver a Past Two, a Vocab, a Amaban, a Morían, a Montaban, a Corrían y a Caminaban aquí.

* * *

>i
No lleva nada.

* * *

>east
(first opening Future door)

Futuro
You can see Future door, Past One, Correrás, Dibujarás, Lavará, Leeré and Pondré here.

>n
You can't go that way.

>s
(first opening Past One)
You can't, since Past One leads nowhere.

* * *

>x door
You see nothing special about Future door.

* * *

>toma juega
Cogido.

    *** ¿Por qué? Necesitarás pensar. ***

¿Quieres REINICIAR, RECUPERAR un juego guardado, TERMINAR o hacer UNDO del último comando?

>undo
El uso de "deshacer" no está permitido en este juego.

¿Quieres REINICIAR, RECUPERAR un juego guardado, TERMINAR o hacer UNDO del último comando?

* * *

>habla to juan
( a Juan)
No has provocado ninguna reacción.

>talk to juan
No conozco ese verbo.

>habla a juan
Hint: Oppuesto de entras.

>toma sale
Cogido.

>abre future door con sale
 Quitas el cerrojo a future door.

>e
(abriendo primero Future door)

Futuro
Warning: Don't take the wrong key. Think about the question. Always examine the door first. ¡Hola, tu eres en el Futuro! Tu necesitarás encontrar la llave que abre la puerta. The name of the doors are corresponding with the room it leads to. The Preterite is to the south.

Puedes ver a Future door, a Past One Door, a Correrás, a Dibujarás, a Lavará, a Leeré y a Pondré aquí.

>x past one door
Yo______ mi libro en la estantería.

>toma Leeré
Cogido.

    *** ¿Por qué? Necesitarás pensar. ***

¿Quieres REINICIAR, RECUPERAR un juego guardado, TERMINAR o hacer UNDO del último comando?

>undo
Futuro
[Retrocediendo al turno anterior.]

>toma Pondré
Cogido.

>abre past one door con Pondré
 Quitas el cerrojo a past one door.

>e
No puedes ir por ahí.

* * *

>w
You can't go back, amiga.

>n
No puedes ir por ahí.

>s
(abriendo primero Past One Door)

Preterite
Warning: Don't take the wrong key. Think about the question. Always examine the door first. ¡Hola, tu eres en el Preterite! Tu necesitarás encontrar la llave que abre la puerta. Past one (door) is preterite and past two is imperfecto (door). The name of the doors are corresponding with the room it leads to. The Imperfecto is to the east.

Puedes ver a Past One Door, a Past Two Door, a Fui, a Conduje, a Comí, a Tuvo y a Nadé aquí.

>toma conduje
Cogido.

>abre past two con conduje
 Quitas el cerrojo a past two door.

>e
(abriendo primero Past Two Door)

Imperfecto
Warning: Don't take the wrong key. Think about the question.Always examine the door first. ¡Hola, tu eres en el Imperfecto! Tu necesitarás encontrar la llave que abre la puerta. Past one (door) is preterite and past two is imperfecto (door). The name of the doors are corresponding with the room it leads to. Vocabulary is to the north.

Puedes ver a Past Two Door, a Vocab Door, a Amaban, a Morían, a Montaban, a Corrían y a Caminaban aquí.

>toma amaban
Cogido.

>abre vocab door with amaban
Intenta de nuevo, porque sólo te pude entender: abrir  Vocab Door.

>abre vocab door con amaban
 Quitas el cerrojo a vocab door.

>n
(abriendo primero Vocab Door)

Vocabulary
Warning: Don't take the wrong key. Think about the question. ¡Hola, tu eres en el Preterite! Tu necesitarás encontrar la llave que abre la puerta. The name of the doors are corresponding with the room it leads to. The Final Showcase (Mix) is to the east.

Puedes ver a Vocab Door, a Mix Door, a Sandía, a Ojo, a Policía, a Oso y a Invierno aquí.

>toma oso
Cogido.

>Abre mix door con oso
 Quitas el cerrojo a mix door.

>e
(abriendo primero Mix Door)

Final Showcase
¡Finalmente! Tuviste a la final. Tu necesitarás abrir el baúl ganar. Warning: Don't take the wrong key. Think about the question.

Puedes ver a Mix Door, a Chest (cerrado), a Escucho, a Manzana, a Besaba, a Cantará y a Zapato aquí.

>toma zapato
Cogido.

>Abre chest con zapato
 Quitas el cerrojo a chest.

* * *

>x sale
No observas nada especial en Sale.

>x future door
Ella____la clase ir a dormir.

* * *

>toma todo
no way josé

* * *

>toma sale
Cogido.

>abre future con sale
 Quitas el cerrojo a future door.

>e
(abriendo primero Future door)

Futuro
Warning: Don't take the wrong key. Think about the question. Always examine the door first. ¡Hola, tu eres en el Futuro! Tu necesitarás encontrar la llave que abre la puerta. The Preterite is to the south.

Puedes ver a Future door, a Past One, a Correrás, a Dibujarás, a Lavará, a Leeré y a Pondré aquí.

>w
No puedes ir por ahí.

* * *

>e
(abriendo primero Future door)

Futuro
Warning: Don't take the wrong key. Think about the question. Always examine the door first. ¡Hola, tu eres en el Futuro! Tu necesitarás encontrar la llave que abre la puerta. The Preterite is to the south.

Puedes ver a Future door, a Past One, a Correrás, a Dibujarás, a Lavará, a Leeré y a Pondré aquí.

>x w
No ves nada en especial al mirar en esa dirección.

>w
You can't go back, amiga.